// level: ashmoor_entrance
// P = player start, D = door/exit
// L = light, # = wall, . = floor

#########################
#...........#...........#
#...........#...........#
#.....L.....#...........#
#...........#...........#
#..P........#######D#####
#.......................#
#.................L.....#
#########################